000100101010100001010000001000000000000000000000000000000110
000000010000110000000010000000000010100000000000000001000000
000000000100000000000000000000100001010000001010010000000001
000000000000000000000010001000000110000000000001000000001000
000000010000000001100000000000010000100000000001010000000100
100010000000001000110000000000000001000100000000000000000001
000001000000010001000000000100000000100010000000100000100000
000000000000100001000000000000100000000001000000100010000001
000000000001000000010000000000000000100100100000000000000010
000000000000000000000000101000000000001101000100110000010001
000000000000001000000000000100001000000000010000000000000000
000001001000110000010000100000000000100000001000000000000000
000000000001100101000000100000000000010000000100000000010000
000001000000100000000001100000010000100001000000000000000000
000000100000000000000100100010001000000000000000000000000010
000000000000000000000000001010000100000000000000000100000000
000000000000000000000000001000000000010000000010000100001100
000010001000000000110000101000000100000000000000001000000011
000001001000001000101000011000000001110001011101100000000000
000000000000000000100000000010001000000000001000010010000010
000000000010000000000000010000000000100000010000001000000000
001000000100001000000010000000001001000000000000001110000000
000100100010000000010000000000000000000100000000000010100100
000000000000000000000000000000001000100001000000000001000000
000000100000000100000000000000001000001000000000000000000000
000000010010000001100000000000000000001000000000000000010000
000000000000000010000011000000000000000000000000000000010000
100000000001000001000000001010000000100001001000000000000100
000100100010100001001000000000000000000001010000000011000000
000000000000000000000000000000000001000010000100000010000010
000000010000000000000000000010000000001000000000001000000001
000000000010000000000110000000000001000010000000011001010000
101010000000110000000000010000000000000100000011000000000001
000000000000100000100000001000000000001000100101000010000000
000000000000000000000000000000010000010100000000000000000000
100000000001000000110000100000000000100000010000000100000001
000100100000000100000000000000001000001000100010010100000000
000000001000000000000000000000000000001000000100000000000000
000100001000000101000010001100000100000000000000100000100001
001000000000001000010100000010000000010000000000011100000000
000000000001000000000000000001100001000000000000000110000000
