000010000010010000010000001000100000101000000010000000100000
000000000011100000000000000000010001001000001000000000000100
010000000000000000010000011000000001000001000000000000010000
110001100000001100110110010000000000000000001000001000100011
000000000100001000000000001100000001000100000010000000001000
001010000000000000001000000100000000000000000001000000000000
100001001100110000000000100000110000000111000000000000000000
010000001000000000000000000100001000000000000000010000000000
000000000000100000000101000000000000000001000100000100000000
010001000000000000001101000000000000010000000000100000000000
000000000000010000010001000010000001000100000000010001100000
001000000000010100110000000000000000000000100000000000001010
000001000000000010000000000010100000001000000000000001000000
000000000000110100100001001000000000000100000000000000000000
000000001001010001101000001000000001000000000001100000000010
000000000000000000000000000000000010000000000010000000000010
000010000000000000000001000001000000000000000000100000000000
000000001000000000111101010001100001000000010000100000010000
000000001000000000000000000000000000000000000010010000001000
000001000001000000001000001000010000000010001100100000000100
000110000000000000000001001001000100000000000000000000010010
000010000000000100000001000000000000010000000000000010001100
000000000000000000000000000000000000000000000000010100000001
101010000000000010100001000000101000000000000000000000000000
000000100010000000000000000010000000000000000010000000000000
000010001010000000000000100000010010010000000000000000000010
000011000100000000010000000000000000000000000010100000100001
000000000000010000000000000000000000000010000010001011000001
100000000000010000000000001000010001000101000000001000100001
001001000000000000000000001000000011000000000001000100000001
010000000000000000000001000000000001000000100000000001000001
000000000000000000000100000000000000000100000000000000000000
000000000000000001000000010000000000100000000000000000000000
100100010000000010001000000001001000001001000000100000000000
000000000000000000100001000010010000000001000100000100000001
000000000000100001100001001000000100000001000000000000000010
000000000000001100000000000000100010000100110001100000000000
010000000000000000000000000000010010010000000001000000010000
001000100000000000000001100000000000010000000000000100000110
010010000000001000000000000000000001000000000000000000110000
000000000000000000000000001001000000000001000000010000000000
